****************
*S******* ******
*       ***** **
*******   ******
*** **** *******
*****  *   *****
*********     **
***   **D ***  *
************   *
*              *
* **************
*      *********
*****          *
******    *  ***
***   ** K******
****************