************************
*S******* **************
*       ***** **********
*******   **************
*** **** ***************
*****  *   *************
*********     **********
***D           *********
************   *********
*              *********
* ********* ************
*      *****************
*****          *********
******    **************
***       **************
*******          *******
*****            *******
********* *** **** *****		
******      ***   ******		      
*                      *		 
*  *********************			 
*     ******************			 
*k *********************			 
************************